#####
#   #
# # #
# #-#
#####
