######
#....#
#..###
#....#
#..#.#
######
