#######
#    ##
#     #
#     #
# # ###
# #  -#
#######
