########
#      #
##   ###
#      #
#  #   #
#   # ##
#   # -#
########
