#########
#       #
## ##   #
#  #    #
##  ##  #
#  #  ###
#       #
##    #-#
#########
