###############################
#........#.....#.#.##.##...#..#
#......##.....#....#.......#.##
#.#........#.#.#.#...#.#.##...#
##...##.#.###.#..#.#.###.#...##
#...#.#..#....##..#.#.#......##
####....#...#......#...#.#.#..#
#.###.#.#.###.#.#.#.#...#..#..#
#......#...#.#..##.....##.#...#
##.####...#...##....####.#...##
#...#..#.#.......#.##.......#.#
#..#........#..##.#....##.#.#.#
#.####..#.#.#.#.....#.#..#....#
#....#..#..#..#.#.##.#........#
##...#..#.####..##...#..#.#..##
##..#..#...#...#....#..#.#.#..#
#..#.#..#.###.##......#.....#.#
#..#..##..#.....#.#...#.#..#.##
#..#.#.#.#.#....##.####.......#
#...........#.#.........#..#..#
###############################
