###############################
#B............##.#.##.##....#.#
#............##....#.....#.#..#
#............#...#...#.#..#...#
#..........##.##.#.#..#..##...#
#........##.......#.#.#......##
#.#.....#............#.##.....#
##.#....#.#...#.#.......#..#..#
#......#...#.#..#.##....#.#...#
##.#.##...#.#.##.#...###.#...##
#...#....#.......####.......#.#
#..##.#.##.#.####.#....##.#.#.#
#.##...#....#.......#.#..#..###
#...##.....####.#.####....##.##
##...#.##.##.#...######.#.#.#.#
#..##.##...#...#..###...##.#..#
#.##.#.##.##..##..#.##......#.#
#.....#....#....#.#...#.##.#.##
#.##.#...#.#....##.#.##.......#
#.#.........#...........#..#.F#
###############################
